11111111111111111111
14100000000000000041
10000000000000000001
10141000000001111111
10010000000001400001
10000000000000000001
10000000000000000001
10000000000000000001
10000000000000000001
10000000000000000001
10000000004100000001
11100000000100000001
10000000000100000001
10000000000100000001
10011140000000000001
10000000000001110001
10000000000000000001
10000000000000000001
10000000000000000001
11111111111111111111