11111111111111111111
10000010000100400001
10000010000100000101
11100010000100000101
10000400000001111101
10001110000000000101
10000000000000000001
10010000000000000001
11111100000000010001
10000000000040010001
10000000001111111111
10010000000040000101
10010000100000000101
10010000110000100001
10010000000000100001
10010001111100101111
10010000410000100001
10011001110000100001
10400000000000100401
11111111111111111111
