11111111111111111111
10100001000000001401
10100000000000000001
10141111111000000001
10000000000000001111
10000000000000001001
11001111111000000001
10040001000000000401
10000001000000000001
10000001000111111111
10000001000100000041
10000001000000000101
10040000000001111101
10010000000000010001
10000000100040000001
10000000100000000001
11110000100000111111
10000000000000000001
10000141000000000001
11111111111111111111