11111111111111111111
10001400001000000001
10000000001100010001
10011111100000040001
10000000000000010011
10011100011111110001
10010000000410000001
10010000000000000001
10010000000000011101
10000000000000000001
11111111000111111111
10000000000000000101
10111110000000000141
10000000000001111101
11100010000000000001
14000100011110000001
10001000000010011111
10010400001010000001
10000000000010001041
11111111111111111111